{
  "width": 10,
  "height": 8,
  "tiles": [

    [0,0,0,0,0,0,0,0,0,0],
    [0,1,1,1,1,1,1,1,1,0],
    [0,1,1,1,1,1,1,1,1,0],
    [0,1,1,1,1,1,1,1,1,0],
    [0,1,1,1,1,1,1,1,1,0],
    [0,1,1,1,1,1,1,1,1,0],
    [0,1,1,1,1,1,1,1,1,0],
    [0,0,0,0,0,0,0,0,0,0]
  ],
  "tileDefs": [
    { "id": 0, "image": "/static/tilegame/map_assets/grass.png" },
    { "id": 1, "image": "/static/tilegame/map_assets/dirt.png" }
  ]
}